|000|000|025|000|000|000|000|000|000|000|
|000|000|025|000|000|000|000|000|000|000|
|000|000|025|000|000|000|000|000|000|000|
|000|000|025|000|000|000|000|000|000|000|
|000|000|025|000|000|000|000|000|000|000|
|000|000|026|001|001|001|000|000|000|000|
|000|000|000|000|000|000|000|000|000|000|
|000|000|000|000|000|000|000|000|000|000|
|000|000|000|000|000|000|000|000|000|000|
|000|000|000|000|000|000|000|000|000|000|