000|000|025|023|000|000|000|000|000|000
000|000|025|023|000|000|000|135|000|000
000|136|025|023|000|000|000|000|000|000
000|000|025|023|000|000|000|000|000|000
000|000|025|046|047|047|004|000|000|000
000|000|026|001|001|002|023|000|000|000
000|000|000|000|137|025|023|000|000|000
000|137|000|000|000|025|023|000|000|000
000|000|000|000|000|025|023|000|000|000
000|000|000|000|000|025|023|000|000|000